行動を代わる	の を	問題解決などの 知的行動を
記述をする	の を	知能の 記述を
注目をある	という を	強化学習という 注目を
経験を行う	の を	自らの 経験を
流行をする	て を	超えて 流行を
学習をする	を	学習を
学習をする	て の や を を	なされている。 エキスパートの ニューラルネットワークや 推論ルールを、 統計的学習を
進化を始まる	て の を	行っていく 人工知能の 進化を
処理をする	が を	XMLが 処理を
処理をする	が を	試みが 知的処理を
意味を行う	て を	付加して、 意味を
処理をする	を を	方法を 知的処理を
運転をする	が を を	モデルが ブームを 運転を
特許をなる	から て を	事から、 なっていた 特許を
研究をする	を	研究を
注目を集める	から は も も を	ことから、 洗濯機としては 制御技術であるにも 高級路線にも 注目を
制御をする	の を	従来の ニューロファジィ制御を
制御をする	を を を	ブームを 知的制御を 製品を
成功を用いる	て も を	受けて、 他社も 成功を
制御をする	や を	工作機械や 制御を
進歩をする	で の を	点で 科学技術の 進歩を
プログラムをする	に の を	模擬試験に 東大の 専用プログラムを
研究をする	の を	独自の 研究を
注目を持つ	を	注目を
普及を受ける	を	普及を
学習を組み合わせる	を	機械学習を
開発を投じる	て の の を を	集めて AI兵器の 中国の 天才児を 研究開発を
開発をする	の を	AIの 研究開発を
シミュレーションをする	を を	深層学習を脳シミュレーションを 深層学習を脳シミュレーションを
反乱をいる	て の は を	鳴らしている 人工知能の 松尾豊は、 反乱を
弾圧を併せ持つ	を	弾圧を
監視をする	の や を	警察の サングラス型スマートグラスや 監視を
展開をなる	を を	展開を 軍事バランスを
記録をする	を	記録を
追及をする	と を	モデリング」と 追及を
研究を呼ぶ	に も を	同様に 際も 共同研究を
解任をする	という の は を	判明した」という 委員会の Googleは 解任を
存在を語る	て の を	応じて、 自分の 霊的存在を
*
を示す	て と と の は を を を	示している。 歴史などと 神と Googleの アンソニー゠レバンドウスキーは 振る舞いを 裁判を 道)」を
疎通をできる	も を	使っても、 意思疎通を
勘違いをする	によって の を	専門誌によって 一般読者からの 勘違いを